99999999999999999999999999999999999999999999999999999999999999999999999999999999999999999999999
92222222222992300000000033333333333333333333333333333322222222222111111222222222222922222222229
92222222222992343333333050000005050000000000505000050322222222222111111222222222222922222222229
92222222222992303111113333333333433333333333343333334333333333333112222333333333333933333333339
92222222222992303111112222222223031111111111303222230500000000503112222305000000503950000005039
92222222222992303333333333333333431111111111303299234333333333343112222343333333343933333333439
93333333332992305000000050500005033333333333343299230311111111303111111303111111303931111113039
93111113032222343333333334333333050000505000503222230311111111303111111303111111303931111113039
93111113032222303111111130322223433333343333333333334333333333343333333343333333343933333333439
93333333432222303111111130322223032222303112222221130505000000505000000005000000503950000005039
90500005032222303112221130311113031111303111111111134343333333343333333343333333343933333333439
90333333432222303112221130311113031111303111111111130303112211303111111303111111303931111113039
90311113032222303112221134333333433333343333333333330503112211303111111303111111303931111113039
90311113032222303112221130505005050000505005000503133343111111343333333343333311303933333113039
90333333432222303333333333333433333333333343333303111303111111305000005005050311303950503113039
90500005032222303111111111113031111111111303111343333343333333333333333433334311303933343113039
90333333432222303111111111113031111111111303111305000505000503999999993031130311303911303113039
90322223033333343333333222113031122222211303222343333333333343922222293031130311303911303113039
90322223050000500500003222113032222222222303222303112222211303929999293031130311303911303113039
90322223033333334333333222113032222211111303111303111111111303929229293031130311303911303113039
90322223032222230311113111113031122211111303111303111111111303929222293031130311303911303113039
90322223032222230311113111113031122211333343333343333332222303929999993433334311303933343113039
90322223032222230333333333333431111211300505000505005032222343333333333005000311303950003113039
90322223032222230311221130505031111211343333333333333431111305005000005003333311303933333113039
90322223032999230311221134333433311211303111122211113031111333343333333343111111303931111113039
90333333432999230311221130313050311211303111122211113031122211303111111303111111303931111113039
90005005032999230311221130313334311211303112222222113031122211303111111343333333343933333333439
99903333432999230311221130311130311211303222929992223031111111303116666305000000503950000005039
99903113032222230311221130312134333333343112929292113031111111303116611343333333343933333333439
99903113033333334333333334312130500050503112922292113433333333343116611303112211303931122113039
99903113050000050500505050312133333334333112999992113050000000503111111303112211303931122113039
99903113433333334333343333312111111130322112222222113433333333343111111303112211303931122113039
99903113031111130311303111112222222130322111221221113031111111303333333343333333343933333333439
99903333431111130311303111112111111130322111221221113031111111305000000505000000503950000005039
90005005032222230311343333333333333334333333333333333433333333343333333343333333333933333333339
90333333331111130311305000005050000050500505005050005050000000503111111303112211222931122112229
90311122231111130311343333333433333334333343333433333333333333343111111303112211222931122112229
90311133333333334311303112113031111130399303113031111111111111303112211303112211222931122112229
90322230500000050311303112113031111130399303113031111111111111303112211303112211222931122112229
90322234333333333311303112113433331130399303113031122222222222343333333343333333333933333333339
90311130311111111111303111113005031130399303113031129922222992305050500505000000503950000005039
90311130311111111111303111113333031130399303113031129922222992333334333343333333343933333333439
90333334333333333333343333333333433334333343113031122222222222221130311303111111303931111113039
90500050500000000050505000000005000050500503113031111111111222221130311303111111303931111113039
90333334333333333334333333333333333334333343113031111111111222221130311303112211303931122113039
90311130311111111130311111111111112230311303333433333333333333333334333343112211303931122113039
90311130311111111130311111111111112230311305005050005050500000050500000503112211303931122113039
90321130311222222230311333333333112230311333333333343334333333334333333343333333343933333333439
90321130311222222230311305000503112230311111111111303230311111130311111305000050503950000505039
90311130311111111130311343333343111130311111111111303230311111130311111303333330333933333303339
90311130311111111130311303222303111130322233333222303230333333334333333343333334322933333343229
90333334333333333334333343333343333334333333333333343330500000050500000505000050322950000503229
90000000000000000000000000000000000000000000000000000000333333333333333333333333322933333333229
90500050500000000050505000000005000050500503113031111111111222221130311303111111303931111113039
90333334333333333334333333333333333334333343113031111111111222221130311303112211303931122113039
90311130311111111130311111111111112230311303333433333333333333333334333343112211303931122113039
90311130311111111130311111111111112230311305005050005050500000050500000503112211303931122113039
90321130311222222230311333333333112230311333333333343334333333334333333343333333343933333333439
90321130311222222230311305000503112230311111111111303230311111130311111305000050503950000505039
90311130311111111130311343333343111130311111111111303230311111130311111303333330333933333303339
90311130311111111130311303222303111130322233333222303230333333334333333343333334322933333343229
90333334333333333334333343333343333334333333333333343330500000050500000505000050322950000503229
90000000000000000000000000000000000000000000000000000000333333333333333333333333322933333333229
99999999999999999999999999999999999999999999999999999999999999999999999999999999999999999999999