99999999999999999999999999999999999999999999999999999999999999999999999999999999999999999999999
99922222299999900000000099999999999993333333333333333322299992222111111222222222222229999999999
99222222299999903333333000000000000000400000404000000322222222222221111222222222222222999999999
92222222229999903111113333333333433333433333303333330333333333333122222333333333333333399999999
92222222222999903111112222222223031111411111303222230400000000003112222304000000400000400000999
92222222222999903333333333333333031111411111303299234333333333303122222303333333342033333330999
93333333222999904000000040000004033333433333303299230311111111303221111303111111302032222230999
93111113222222343333333334333333040000400000403222230311111111303111111303111111302032222230099
93111113222222303111111130322223433333303333333333330333333333343333333303333333302433333333099
93333333332222303121112130322223032222303112222221130400040000404000000404000000400040000004099
90000004032222303122222130311113031111303221111112230303333333303333333343333333342033333333439
90333333032222303112221130311113031111303121111112134343112211303111111303111111302031111113039
90311113032222303112221130333333433333343333333333330003112211303111111303111111302031112213039
90311113032222303112221130000004000000004004000403233343122221303333333343333322302433333213039
90333333432222303333333333333433333333333303333303222303111111300000004000000322300040003113039
90400004032222303111111111113031111111111303111343333343333333333333333433330311303333303333439
90333333032222303111111111113031111111111303111300000400000003999999993031130311303111304000039
90322223033333343333333333333439292222222303222303333333333343922222293031130333303121343333339
90022223040000400400000000004032292992222303222303122222221303929999293031130000403121303999999
99002223433333334333333333333032922299111303111303121111121303929219293031133333343121303333339
99900023032222230311113111113032929229111303111303111111111303929222293031132211303111304000039
99999004032222230311113111113032229292333343333343333332222303929999993033332211303333343333039
99999993432222230333333333333439929922300004000400000032222303922222223033222222302000003113039
99992223032292230311221130004032229229303333333333333031111303333333333433222222302433333113039
99922223032999230311221130333033322211303121122211213031211300004000004003111111302031111223039
99233333439999930311221130393000399211303221122211223031222333343333333343111111302031111213039
99900004032999230311221130333330322211303112922222113031122211303111111303333333342033333333039
99903333032999230311221130311130329911303222929992223031111221303112211300000000400040000004039
99903113032292230311221130312130333333303112929292113031111111303112211343333333302433333333439
99903113033333334333333330312130000040003112922292113433333333303112211303112211302031122113039
99903113040000040000004000312133333334333112999992113040000000403112211303112211302031122113039
99903113433333334333343333312111111130322112222222113033333333343112211303112211302031122113039
99903113031121130311303111112222222130322221111111223031111111303333333343333333342033333333039
99903333031121130311303111112111111130322121111111213031111111304000000004000000400040000004039
90004000032222234444443333333333333330333333333333333433333333303333333303333333333333333333339
90333333331121130311304000000040000040400004000040000040000000403121121303112211222221122113299
90311122231121130311303333333433333334333343333433333333333333343121121303112211222221122113299
90311133333333330311303112113031111130399303113031211111111111303112211303112211222221122113999
90322230000040000311303112113031122130399303113032211111111111303112211303112211222221129993999
90322230333343333322303112113033332130399303113031122222222222303333333343333333333222229993339
90311130311141111222303122213000031130399303113031129922222992300040000400000000403229999993139
90311130311141111222303111113333031130399303113031129922222992333330333343333333343222999993339
90333334333343333333343333333333033334333303113031122222222222221130311303111111303222229999999
90400000400040000000004000040004040040400403113032211111111222221130311303121121303222222299999
90333330333333333333333333343333333334333343113031211111111222221130311303122221303221122299999
90311130311111111111311111141111112230311303333433333333333333333334333303112211303221122229999
90312130312211111111312211141112212230311300000040000040400000040040000403112211303221122229999
90321130312222222222312333343333212230312333333333333330333333334333333343333333343333333333339
90321130312222222222311300040003112230312211111112222230331111130311111304000000404000000004039
90312130312211111111311303333303221130311111111112292230331111130311111303333333333333333333039
90311130311111111111311303222303121130322233333332999230333333334333333303222222223333333333439
90333334333333333333311303222303333330322233333332292230400000000400400403222222223040000000039
90400040000000000040333343333343333334333300000032222233333333333334333343222222223033333333039
90333334333333333330400400040004000000000403333031111111111222221130311303221111223032222223039
90311130311111111134333333333333333334333343113031111111111222221130311303221111223031122113039
90312130312211111130312111292111212230311303333433333333333333333334333303222222223031122113039
90321130312223333330322111292111222230311300400040004000000000040040000403222222223031122113039
90321130311223040000311333333333112230311333433333343334333333334333333343333333333433333333439
90321130312223033333311300040003112230322111411111303230331111130311111304000040000040000400039
90312130312213032222311303333303221130312111411111303230331111130311111303333334333033333343339
90311130311113032222311303222303121130322333433322303234333333430333333343333330323033333303229
90333334333333433333333343292343333334333333433333343330400000040400000000000000323040000003229
90400000400000040040000403222304000040000000400000400000333333330333333343333333323333333333299
90333330333333333334333303333303333330333333333333333334331111130322222303222299222222222222299
90321130312222222230322300040003222230311122221112222230331999130311111303222999922222222222999
90312130312111111130311343333343122130311122221112222230331111130311111303222299222222222222299
90311230312111111130311303222303111130322222222222222230333333334333333343222299222222222222229
90333334333333333330333303222303333330322333333332222230400000000400000403222222222040000000029
90400000400000000040333343333343333334333300000033333333333333333333333303222222222033333333029
93333334333333333330400400040004000040000403333031111111111222221199911303111111222032222223029
99222130312111111134333333343333333033333343993031111111111222221199911303122221222031122113029
99921230322111111130312111343111213433311303333433333333333333399999999303112211222031122113029
99922130311222233330322111343111223040311300004000004000400004099999999303112211222031122113029
99992230311222230000311333343333113330311333333333343330333333000999999343333333333433333333429
99992130311222230333311399999993112230312111111111303230339993330000000000409990000000000000029
99992230322111130322311393333393111130312111111111303234339933333333999999309990333333333322229
99992230312111130322311333212333221130322233333222303230999331212123333999300990322121212122229
99999234333333334322311393333393121134333333333333343330999332121222223333330000322212121222999
99999230000000000333333399999993333330000000000000000000999933333333333999933333322222222229999
99999999999999999999999999999999999999999999999999999999999999999999999999999999999999999999999